#################################################
#....s...###..........................#.........#
#........#.#....##..........##........#.........#
#........#......##..........##........#.........#
#........#............................#.........#
#........#............................#.........#
#........#......##..........##........#.........#
#........#......##..........##........#.........#
#........#..................##........#.........#
#@....................#.........................#
#........#............#.....##........#....#....#
#........#......##..........##........#....#....#
#........#......##..........##........#....#....#
#........#............................#....#....#
#........#............................#.........#
#........#......##..........##........#.........#
#........#.#....##..........##........#.........#
#........###..........................#.........#
#################################################